"filename", "language", "Dart", "comment", "blank", "total"
"/home/mdd/文档/flutter/my_blog/lib/aboutPage.dart", "Dart", 100, 0, 6, 106
"/home/mdd/文档/flutter/my_blog/lib/articalPage.dart", "Dart", 239, 3, 13, 255
"/home/mdd/文档/flutter/my_blog/lib/detailArtical.dart", "Dart", 225, 0, 14, 239
"/home/mdd/文档/flutter/my_blog/lib/homePage.dart", "Dart", 110, 0, 7, 117
"/home/mdd/文档/flutter/my_blog/lib/main.dart", "Dart", 88, 0, 9, 97
"/home/mdd/文档/flutter/my_blog/lib/messagePage.dart", "Dart", 59, 0, 8, 67
"/home/mdd/文档/flutter/my_blog/lib/messageWidget.dart", "Dart", 220, 0, 8, 228
"/home/mdd/文档/flutter/my_blog/lib/test.dart", "Dart", 9, 0, 3, 12
"/home/mdd/文档/flutter/my_blog/lib/values.dart", "Dart", 77, 0, 5, 82
"Total", "-", 1127, 3, 73, 1203